11111111111
1         1
122222222 1
1         1
1 222222221
1  222222 1
12   2222 1
122   222 1
12222     1
11111111111